00000000011000000000
00001000000000010000
00000000000000000000
10000000000000000001
10000000000000000001
00000000000000000000
00001000000000010000
00000000011000000000