00000000000000000000
00000100000000100000
00000000000000000000
00000000011000000000
00000000011000000000
00000000000000000000
00000100000000100000
00000000000000000000